XXXXXXXXXXXXXXXXXXXXXXXXXXXXXXXXXXXXXXXX
X S                 B                S X
X    X                           X     X
X    X         C       C         X     X
X    X       XXXXXXXXXXXXXX      X     X
X                                      X
X                                      X
X                                      X
XXXXXXXX                        XXXXSSSX
XXXXXXXX            G       XXXXXXXXXXXX